{
    "level": 11,
    "rows": 8,
    "cols": 12,
    "tiles": [
        "A", "A", "F", "F", "K", "K", "M", "M", "G", "G", "D", "D",
        "B", "B", "E", "E", "H", "H", "J", "J", "L", "L", "N", "N",
        "C", "C", "I", "I", "O", "O", "P", "P", "Q", "Q", "R", "R",
        "D", "D", "E", "E", "H", "H", "J", "J", "L", "L", "N", "N",
        "A", "A", "F", "F", "K", "K", "M", "M", "G", "G", "D", "D",
        "B", "B", "E", "E", "H", "H", "J", "J", "L", "L", "N", "N",
        "C", "C", "I", "I", "O", "O", "P", "P", "Q", "Q", "R", "R",
        "D", "D", "E", "E", "H", "H", "J", "J", "L", "L", "N", "N"
    ]
}