{
    "level": 9,
    "rows": 8,
    "cols": 6,
    "tiles": [
        "M", "M", "C", "C", "J", "J",
        "A", "A", "L", "L", "F", "F",
        "B", "B", "H", "H", "E", "E",
        "G", "G", "A", "A", "B", "B",
        "M", "M", "D", "D", "F", "F",
        "K", "K", "L", "L", "C", "C",
        "H", "H", "G", "G", "E", "E",
        "J", "J", "D", "D", "K", "K"
    ]
}