{
    "level": 8,
    "rows": 7,
    "cols": 6,
    "tiles": [
        "J", "J", "A", "A", "G", "G",
        "E", "E", "C", "C", "D", "D",
        "B", "B", "G", "G", "H", "H",
        "K", "K", "L", "L", "B", "B",
        "A", "A", "D", "D", "C", "C",
        "E", "E", "H", "H", "F", "F",
        "F", "F", "K", "K", "J", "J"
    ]
}