{
    "level": 7,
    "rows": 6,
    "cols": 6,
    "tiles": [
        "M", "M", "C", "C", "L", "L",
        "H", "H", "T", "T", "B", "B",
        "D", "D", "A", "A", "C", "C",
        "L", "L", "B", "B", "M", "M",
        "D", "D", "T", "T", "H", "H",
        "A", "A", "F", "F", "F", "F"
    ]
}